1111111111111111111111111111111111
11000000PCCCCCCE000000000000000001
1111111111111111111111111111111111