1111111111111111111111111111111111111111
100100P0C0E01111111111111111111111111111
1001CCCCCCCC1111111111111111111111111111
1001000000001110001111100111111111111111
1100110000001111111111111111111111111111
1100011111001110011000000111111111111111
1111111111111110001111100111111111111111
1100110000001111111111111111111111111111
1001000000001110001111100111111111111111
1100110000001111111111111111111111111111
1111111111111111111111111111111111111111
1001000000001111111111111111111111111111
1001000000001111111111111111111111111111
1001000000001110001111100111111111111111
1100110000001111111111111111111111111111
1111111111111111111111111111111111111111
1001000000001111111111111111111111111111
1001000000001111111111111111111111111111
1001000000001110001111100111111111111111
1100110000001111111111111111111111111111
1111111111111111111111111111111111111111
1111111111111111111111111111111111111111
